11111111111111111111111111
10E10000001000000001C10001
1011C111101010111101010101
101001C1001010000101010101
10111101011011110100010101
1010000100C010000101110101
1010101111110C111101010101
1010100100010100010C010101
10101000C10101010111010101
10111101110101010C10000101
101C0000010001011111111101
1011110111111100100000C001
100C1000000101101011101101
101110111101C000101C100101
101000C1010111000010000101
10101111010101111010111101
100000010001000000101000P1
11111111111111111111111111