11111111111111111111111111
1001C000000000001000000001
10011111110111100011111001
100001000001C0101000000001
10111111110100100011111111
100100000000001010000000C1
10010111111100100011111101
10010100000000100010000101
1001010001100011101011C101
10000100011010010010111101
10101100011000010010100001
1010C100011000010010100001
10111100011001000010100001
10101001000001000010001001
10101001000001110010000001
10001111110001000011111001
1P1011E00C0001000000C00001
11111111111111111111111111