11111111111111111111111111
10001000100010001C00P00001
10101010101010101111111101
10101010101010100000000101
10101010101010100010000001
10100010C01000100111111111
10111111111111111100100001
100010000000000001C0E00001
10001C00001111100100100001
1000111110000C110111111101
10111001001111010010000101
10000001000001000010010101
10001001001001110010010101
10000001000000010010010001
11111001111111010010111111
10C00000000000010010000001
1000100000000001C000000001
11111111111111111111111111