11111111111111111111111111
10000000000C00000000100001
10111111111111111110101C01
1000010C00000000C010101111
10000101111111111010100001
1C11110100000C001010111101
10000101011111101010100001
11110101C10000101010101111
10000101010110101010C00001
101111010101EP101010111101
10C00101010111101010100001
111101010100C0001010101111
10000101011111111010100001
10111101000C000000101111C1
10000101111111111110100001
11110100C00000000C00101111
10C00111111111111111100001
11111111111111111111111111